OOOOOOOOOOOOOTOO
OOOOOOAOOOOOOPOO
OOAOOOOOOOOOXXOO
OOOOOXXOOOOOOOOO
OOOPOOOOOOOOOOOO
OOXXXXOOOOOCOOTO
OTOOOOOOOXXXOOOO
OOFOOOOOOOOOOCOO
OXXXXXXOOOOOOXXO
OOOOOOOOOOOOOOAO
OOCOOOOOOOOOOOOO
----------------