OOOOOOOOOOOOOOOO
OOTOOOOOOOOAOOOO
OPOOOOOOOOOOOOOO
XXXXXOOOOCOOOXXO
OOOOOOOOOOOOOOOO
OOXXXXXOOOOOOXXO
OOOOOOOOOOOOOOOO
OOOOOOOOOOOOPOOO
OOOXXXOOOOOOOOOO
OOOTOOOOOOOXXOFO
OOOOCOOOOOOOOOOO
----------------