OOOOOOOOOOOOOTOO
OOOOOOOOOOOOOOOO
OOAOOOOOOOOPOOOO
OOOOOOOXXOOOOOOO
XXXOOOOOOOOOOOOO
OOOOOOOOOCOOTOOO
OOFOOOXXXXXXXOOO
OOXXOOOOOOOOOOOO
OOOOOOOOOOOXXOOO
OOOOOOOOOOOOOOOO
OCOOOOOOTOOOOOPO
----------------